go up / rise - wzrastać
high / strong wind - silny wiatr
light / hard rain - słaby / silny deszcz
rainy - deszczowy
reach ... degrees - dochodzić do ... stopni
showery - deszczowy
spell of bad weather - okres brzydkiej pogody
spring - wiosna
stay warm - pozostaje ciepło
summer - lato
sunny - słoneczny
warm - ciepły
windy - wietrzny
windy - wietrzny
winter - zima
branch - gałąź
bush - krzak krzew
grass - trawa
leaf - liść
root - korzeń
seed - nasiona
weed - chwast
bark - kora
bat - nietoperz
bird - ptak
butterfly - motyl
deer - jeleń
deer - jeleń
dolphin - delfin
domestic animals - zwierzęta domowe
donkey - osioł
farm animals - gospodarskie zwierzęta
fly - mucha
fox - lis
guinea pig - świnka morska
insect - owad
jellyfish - meduza
lizard - jaszczurka
mammal - ssak
mosquito - komar
octopus - ośmiornica
owl - sowa
parrot - papuga
pigeon - gołąb
polar bear - niedźwiedź polarny
rabbit - królik
rat - szczur
reptile - gad
salmon - łosoś
shark - rekin
snake - wąż
swan - łabędź
trout - pstrąg
turtle - żółw
water animals - zwierzęta wodne
whale - wieloryb
wild animals - dzikie zwierzęta
wolf - wilk
cave - jaskinia
cliff - klif
coast - wybrzeże
coral reef - rafa koralowa
desert - pustynia
field - pole
fishing village - wioska rybacka
flow - płynąć
forest - las
hill - wzgórze
island - wyspa
jungle - dżungla
lake - jezioro
mountain - góra
mountain peak / top - szczyt góry
nature - przyroda
ocean - ocean
path - ścieżka
rainforest - las deszczowy
river - rzeka
road - droga
route - szlak
scenery - krajobraz
sea - morze
shore - brzeg
stream - strumień
valley - dolina
volcano - wulkan
waterfall - wodospad
wood - mały las
acid rain - kwaśne deszcze
cause destruction to sth - powodować zniszczenie czegoś
endangered species - gatunek zagrożony wyginięciem
environmental problem - problem środowiska
extinct species - wymarły gatunek
global warming - globalne ocieplenie
greenhouse effect - efekt cieplarniany
melting ice caps - topniejące lodowce
overpopulation - przeludnienie
ozone layer - warstwa ozonowa
pollution - zanieczyszczenie
rising sea levels - podnoszący się stan wód
threaten sth - stanowić zagrożenie dla czegoś
ban pesticides - zabronić stosowania środków owadobójczych
build bike routes - budować ścieżki rowerowe
develop renewable energy sources - rozwijać odnawialne źródła energii
fill the car up with unleaded petrol - tankować samochód paliwem bezołowiowym
get involved in wildlife conservation - zaangażować się w ochronę przyrody
invest in solar energy - inwestować w energię słoneczną
recycle waste - poddawać odpady recyklingowi
use public transport - korzystać z transport publicznego
avalanche - lawina
drought - susza
earthquake - trzęsienie ziemi
flood - powódź
forest fire - pożar lasu
hurricane - huragan
tsunami - tsunami
volcanic eruption - erupcja wulkanu
astronaut - astronauta
Jupiter - Jowisz
launch sth into space - wystrzelić coś w przestrzeń kosmiczną
Mercury - Merkury
put sth into orbit - umieścić coś na orbicie
satellite - satelita
space shuttle - prom kosmiczny
space station - stacja kosmiczna
space tourism - turystyka kosmiczna
Uranus - Uran
Venus - Wenus
a foot deep - głęboki na stopę
birthday treat - urodzinowa niespodzianka
clear up - posprzątać
constant worry - nieustanny powód do zmartwień
go along with sth - przystawać na coś
icy conditions - ślizgawica
in sight - w perspektywie , w zasięgu wzroku
air pollution - zanieczyszczenie powietrza
air quality - jakość powietrza
breathing difficulties - problemy z oddychaniem
great cause for concern - ogromny powód do zmartwień
heat up your house - ogrzewać dom
heating fuel - paliwo opałowe
life expectancy - średnia długość życia
poisonous - trujący
region - region
spa town - miejscowość uzdrowiskowa
worrying - niepokojący
jesień - blue sky
błękitne niebo - chilly / frosty
mroźny - clear / cloudless sky
bezchmurne niebo - cloudy
pochmurny - constant rain
nieustający deszcz - degrees Celsius / centigrade
stopnie Celsjusza - dense / heavy / thick fog
gęsta mgła - drop / fall to ... degrees
spaść do ... stopni - foggy / misty
mglisty - frost
mróz szron - high / low temperatures
wysokie / niskie temperatury - icy
lodowaty - light wind
delikatny wietrzyk - mild
łagodny - overcast
bardzo pochmurny - plenty of sunshine
bardzo słonecznie - snowy
stormy / thundery - śnieżny 
burzowy - soil
gleba - tree
drzewo - bee
pszczoła - eagle
orzeł - fish
ryba - seahorse
konik morski - climate change
zmiana klimatu - avoid using plastic bags
unikać korzystania z plastikowych torebek - Earth
Ziemia - land on the Moon
wylądować na Księżycu - Mars
Mars - Neptune
Neptun - Saturn
Saturn - harmful